20
20
....................
....................
........WWWWW.......
....................
...W................
...W................
...W................
...W...........W....
...W....W......W....
...WWWWWW.....WWWW..
........W......W....
...........W...W....
.W.........W........
.W.......WWW........
.W..................
....................
....WWWWWW.....WWW..
...............W....
..............WW....
....................